XXXXXXXXXXX
X. #  Y   X
XX XX XX XX
 X       X 
 X       X 
 XXXXXXXXX  